111111111
10P00C001
100000001
10C1000E1
111111111