111111111
10P00C001
100000011
10C10E1C1
111111111