111111111
10P00C001
10000A001
10C1000C1
111111111