111111111
10P00C001
100000001
10C100EC1
111111111