1111111111111111111
10P00C00000C0000001
10000000000000C0001
10C100EC000000C0001
1000000000000000001
10001111100C00C0001
1000111110000000001
1000000000000000001
100000C00000C000001
1000000000000000001
10000000000C0000001
1111111111111111111