111111111111111
1P0000010000001
101111101111111
1C000C0000C0001
111011111101111
1C0001000C000E1
101110101111101
1C000C0000000C1
111111111111111
